3333330000333333
3333333003333333
3333000000003333
0033333333333300
0000333333330000
0000003333000000
3333000033330000
0000333300003333
3300330033003300
0033003300330033
3300003333000033
3333000033003333
3333003300003333
3333330033330000
0000330000333333
3300000033330000
3333330000000000
0000000033330033
0000330000333300
3333003300003300